111111111111111111111111111111111111111
1P0C100C100C100C100C100C100C100C100C101
1E100C100C100C100C100C100C100C100C100C1
111111111111111111111111111111111111101
100C100C100C100C100C100C100C100C100C101
1C100C100C100C100C100C100C100C100C100C1
101111111111111111111111111111111111111
100C100C100C100C100C100C100C100C100C101
1C100C100C100C100C100C100C100C100C100C1
111111111111111111111111111111111111101
100C100C100C100C100C100C100C100C100C101
1C100C100C100C100C100C100C100C100C100C1
101111111111111111111111111111111111111
100C100C100C100C100C100C100C100C100C101
1C100C100C100C100C100C100C100C100C100C1
111111111111111111111111111111111111101
100C100C100C100C100C100C100C100C100C101
1C100C100C100C100C100C100C100C100C100C1
111111111111111111111111111111111111111