111111111111111111111111111
1P0000000000000000000000001
111000111000000000000000001
111100000000000000000000001
111110000000000000000000001
100000111100000000000000001
1000000111000000000000000C1
1C0000001100000C00000000001
10000000E100000000011000001
111111111111111111111111111